##################################################
##....#...#.#.........#.....#....##.##.......#.#.#
#..##...##.#.#.##.#.##..##.#.##.#......#.##.#....#
###...#....#...#...##.#...##....#.#.#.#.#..#..####
#...#.###.##.##..##....#.#..###....#..#..#..#....#
#.#..#.........#...#.#.#.#.#....#.#.##.#...#.##.##
#.#.#..#.#.##.#..###..#.....#.#..##.#....#....#..#
##..#.#.#.#..#.#....#..##.##...#....#.#.#..#.#.#.#
#.#..#..#...#...##.#..#.#...#.#.##.#..#..##.#....#
##.#.#.#..#.##.#..#..#.#..#.#.#.##...#..#....#.#.#
#.......##...#.#.#..#....##.......###.#...##...#.#
###.###....#.......#.#.##...##.#.#......##..##..##
#.#....##.#.##.#.#..##...###....#.##.##...#....#.#
#..##.#.#..#.##...##...#....##.##......#.#.##.##.#
##.#..#..#....#.#.#.##..#.#..#.#.#.##.#.#...#....#
#...#...##.##..#.....#.#...#.#....#.#...#.#..#.###
#.#..#.#..#...#..##.#.#..#..#..#.#...#.#..#.#.#..#
##..#...#.#.#.#.#...#.#.#.#.#.#....##.#..#..#.#.##
#..#.#.##...#..#..##..#.#..#.#.#.#.#...#..#.#....#
#.#..##..##.###..#...#..##..#.#.#...#.#..##.#.#.##
#.#.#.##...#...#...#..#....#......#.....#.....##.#
#......#.#...##.#.##.#..###.#.##.#.#.##..##.#....#
##.##.#...#.#.......#.#......#.#.#..#...#...#.#.##
#....#..#.#..##.##.#....##.#....#..#..##..#.#..#.#
#.#.#.##...#......#.###.#.#.#.#...#.#.#.#.#..#...#
###..#.#.##.#.##.#.....#....#.#.#....#...#..#.#.##
#...#..#.#...##.#.#.#.#.##.#.#.#..##.#.#..##.#.#.#
###...#..#.##...#.##.....##...#.##...#.##.....#..#
#...##.#....#.#.#....##.#..#.#..#.##.#...#.#.#.#.#
#.#....#.#.#..#..###...#..#...#...#....#.#.##....#
#.#.##..#....#.#....#.#.#...#...##..##..#...##.#.#
##...####.##..#.#.#....#..#.#.#...#.#.##.###.#..##
##.#.....#.#.#...#.#.#...#.#.#.##.#.#.#........#.#
#...###.##....#.#.....#.#..#....##..#..#.##.#.#..#
##.#....#..##.#..#.##.#...#..###..#...#..#.##.##.#
#.#..##...#....#.#.#...#.#.#...#.#.#.##.#..#.#.#.#
#..##.###.##.#.#....#.#.#....#...##......#...#...#
##......#...#.#.##.#...#..##..#.#..#.#.##..#...#.#
##.##.#...#...#...#.#.#.##.#.#....#.##.#..#.#.#.##
#..#...#.#.#.#.##..#.#......#..##........#....#..#
##.#.##.#.#...#...#....#.#.#.#.#.#.#.##.##.#.#.#.#
#..#.#..#.#.#..##...#.#.#..#.#.#.##....#...#.....#
##..#..#..#.#.#.#.##.#.#.#...#.#....##..#.#.#.##.#
#..#..#.#...#......#....#.##.#..#.#...##.#....#..#
#.#..#.#.##.#.#.#.#.#.##...#...#..#.#..#...#.#.#.#
#..#.....#...#.##...#...##...##.##.#.#.#.#.#...#.#
##.###.#...#..#...#...##.#.###...#..#.#.#.#.##..##
#....#..##..#..#.##.#.#........#...#...........#.#
##.##..#...#..#.#...#..#.##.#.#..#..#.#.#.#.#.#..#
##################################################